BigHeartStyle: smartclever, mondiBags, SakeLatin, MyLeatherArt, mybagstore
TresuredTrinkets: TheStrangeStore, MARIPEPAsJewelry, CharliesHandicrafts, YINGZINecklace, ThePeculiarBurrow
Mi3hael: DellAiraDesigns, mybagstore, DucktapeMaster77, JewellGems, MyLeatherArt
CANDYKiDco: sockit2U, OnesieGang, MoreThanSprinkles, MoniKnitsThings, Baugher17
Hope4Humanity: mcNEWagain, CrazyAwesomeTees, Brandtees, GemsApparel, auxieltees
LittleFuzzyBaby: SweetMinkyBaby, MJCLKraft, MoniKnitsThings, OnesieGang, Baugher17
reimaginationarium: angieaustindesigns, CreativeTexasGal, PaperUnique, CieraLShaver, OpticalArtandDesign
VintageRecordClocks: ThePeculiarBurrow, UnknownFractals, CheekyLouDesigns, TheNerdiestMermaid, SifterSupply
Holleybeads: Timmonsjewelry, FordandMcLeod, BelleVieBeads, siyanamitkovaboneva, BuzzysBoHoBoutique
ANDYKIMVASES: CrackerjacksTreasure, ZooGangStudios, PotteryAndKnitting, Minkasembriodery, BunnyandSandy
TruffinCrafts: DucktapeMaster77, KingsCrafts8, LemonFlipFlops, Mi3hael, CardsForToday
TasmanianAdventures: AtlantaVintageBikes, SarednabWorldProp, Snekkerdattera, rareliterature, ShelbisOddsandEnds
EnergyFocusedCrystal: RSMRYVLTG, MarquetteLosAngeles, LILYandLOvintage, JujuKara, Fotobank
HBHali: RobertWreaths, BurtonsBlooms, CreatorLes, Weddingparaphenalia, ShelbisOddsandEnds
Majens: SariasCreates, QINC, JacquelynRosesArt, CreativeTexasGal, JoytotheWORD
StarDustandStuff: CornwallDigitalimage, Zellaknives, DestinedPaintings, NativeEncasements, bowsbyalley
LegoStorageBags: handsofday, CroatianKnit, custombagstudio, TirelessCrafts, ClassyButSassyHouse
VINTAGEBYPAULIE: ZaloozaPaperLove, ARTFEEN, CheekyLouDesigns, HBHali, ANDYKIMVASES
PotteryAndKnitting: ZooGangStudios, ANDYKIMVASES, FuschiaOrchids, ArtExpoRa, HomemadeInDevonByJan
JewellGems: ChezMelleVintage, mybagstore, Mi3hael, CroatianKnit, ArtfulLivingbyJF
CroatianKnit: mybagstore, SakeLatin, MyLeatherArt, custombagstudio, LegoStorageBags
PearlsDistrict: CrazyAwesomeTees, rockabilliy, mcNEWagain, auxieltees, Supercopy
RaminAndSons: MikabayUK, TheAddictHome, Minkasembriodery, CreoFelt, FuschiaOrchids
Donnasdazzlingoneoff: GFPrints, ZooGangStudios, AtlantaVintageBikes, JoiByJen, OPCNaturalDynamics
Temporary5: TheNerdiestMermaid, ChrisConidis, QINC, RobinMasi, BeckysCraftShack
KingsCrafts8: KingsCrafts8, TruffinCrafts, LemonFlipFlops, Mi3hael, mybagstore
BuzzysBoHoBoutique: AngelsFaith, JujuKara, FordandMcLeod, siyanamitkovaboneva, Holleybeads
LCetLB: JaromiraDalebora, laultimapuntada, RAGGSbyLuLu, VintageAlbertini, AliceWonderfulWorld
CraftyGrahams: ScarvesAndSelfies, JoiByJen, LalliandMic, FlowerSistas, YarnAndKnit
CarmelCocoDesigns has no terms!
ConradHeart: HummingbirdHideout, RAGGSbyLuLu, ZTBlack, LCetLB, DesertFaire
Javessimplesmiles: ElleAccessori, YINGZINecklace, JennysStudio, TheStrangeStore, MARIPEPAsJewelry
PacificLandWorks: TheTAbeytaCollection, DunkaDunkShop, aidadelao87, Batoidea, CrackerjacksTreasure
TheTAbeytaCollection: PacificLandWorks, DunkaDunkShop, BerlangaPhotography, aidadelao87, HummingbirdHideout
handsofday: Snekkerdattera, LegoStorageBags, VsLittleMonsters, JewellGems, Smartship
WrassleRoos: bkkclothing, NativeEncasements, bluebeeshirt, ANDYKIMVASES, bolabolasalju
CrackerjacksTreasure: Julyraindrop, ANDYKIMVASES, TheAddictHome, PotteryAndKnitting, ZooGangStudios
RomanBozhkoCreative: BrickTopFurnishings, FabricationHouse, MarcoPoloWood, SouthernFeeling, KitzByBlitz
laultimapuntada: aidadelao87, VintageAlbertini, AliceWonderfulWorld, LCetLB, CieraLShaver
PetrenkoLeatherCraft: MyLeatherArt, SakeLatin, custombagstudio, ChezMelleVintage, HandMadeBackpack
FineScratch: CAPrisonArt, JacquelynRosesArt, RobinMasi, LizeBeekmanART, SariasCreates
BrendasBabyThings: MoniKnitsThings, OnesieGang, Baugher17, MoreThanSprinkles, PitterPattaCakes
UnknownFractals: TeofiliaVintage, AtlantaVintageBikes, VintageRecordClocks, mondiBags, TheAddictHome
MyLeatherArt: SakeLatin, mybagstore, custombagstudio, PetrenkoLeatherCraft, HandMadeBackpack
QINC: Majens, SariasCreates, ChrisConidis, LizeBeekmanART, Temporary5
OpticalArtandDesign: DianeArnoldArtPrints, ANIZART, DesertFaire, JacquelynRosesArt, RobinMasi
OchoPlacas: Brandtees, Hope4Humanity, sockit2U, auxieltees, WrassleRoos
TheCraftyKittens: KnitForDCI, ScarvesAndSelfies, ThisNThatByJes, RAGGSbyLuLu, VsLittleMonsters
DestinationSouvenirs: YINGZINecklace, Sjoerdshop, Kesambi, Mbalelo, TheAlbinoPenguin
SweetMinkyBaby: LittleFuzzyBaby, MJCLKraft, MoniKnitsThings, OnesieGang, Baugher17
SchmuckSchmiede: GundulaGause, Kleiderzauber, ZauberhafteGeschenke, jessisbastelwahn, smartclever
ShelbyAKDesigns: CardsForToday, PaperUnique, DinoInc, Baugher17, AJAirbrushing
smartclever: jessisbastelwahn, BigHeartStyle, GundulaGause, SchmuckSchmiede, Kleiderzauber
TeofiliaVintage: primsNpropers, UnknownFractals, CheekyLouDesigns, LemonFlipFlops, Pleathora
SilkRoadVibes: SossiJewelryDesign, BillsBlingThings, OneCaratGems, GemsByWjtyoung, JujuKara
Verdepistacchio: LalliandMic, Ambramore, LemonFlipFlops, truevintage89, DIN1451
MarquetteLosAngeles: LILYandLOvintage, EnergyFocusedCrystal, JujuKara, RSMRYVLTG, AngelsFaith
jessisbastelwahn: smartclever, Kleiderzauber, GundulaGause, SchmuckSchmiede, ZauberhafteGeschenke
JacquelynRosesArt: LizeBeekmanART, RobinMasi, CAPrisonArt, SariasCreates, FineScratch
GemsApparel: auxieltees, Brandtees, Supercopy, Hope4Humanity, mcNEWagain
YarnAndKnit: ScarvesAndSelfies, CreoFelt, JoiByJen, MINICROP, MoniKnitsThings
acsbk: Pleathora, BillosBoutique, LeatherPatches, HandMadeBackpack, MyLeatherArt
AnimalLetters: Pritchardprints, TheOathDesignStudio, KaykBoutique, ExodusDesign, DianeArnoldArtPrints
ZTBlack: ConradHeart, HummingbirdHideout, BerlangaPhotography, Rimukas, RaglanRoadDesigns
CheekyLouDesigns: TeofiliaVintage, TheAddictHome, primsNpropers, HouseOfSavon, VintageRecordClocks
Rimukas: rareliterature, RaglanRoadDesigns, Pritchardprints, SarednabWorldProp, TheAlbinoPenguin
DestinedPaintings: JoytotheWORD, SharonBsOriginals, MashUpArt, ArtGalleryAngelo, ECZbyElleSkye
TheNerdiestMermaid: Temporary5, ChrisConidis, BunnyandSandy, CieraLShaver, SharonBsOriginals
FarmerSupply: HerPaleoCreations, DayTripApparel, Hope4Humanity, rockabilliy, Brandtees
CardsForToday: PaperUnique, DinoInc, CreativeTexasGal, LeatherPatches, OOOHno
ThePeculiarBurrow: FloridasGems, DaydreamDelusions, TheStrangeStore, MARIPEPAsJewelry, ChitasCreations
NativeEncasements: IRockBlingCases, bolabolasalju, murahaje, Hawian, shouhu
Tutusbybrandy: CharliesHandicrafts, PitterPattaCakes, BubbaJWoodshop, LemonFlipFlops, JoiByJen
CieraLShaver: ChrisConidis, CornwallDigitalimage, TheFrizzyArtist, TheNerdiestMermaid, angieaustindesigns
VsLittleMonsters: BeckysCraftShack, handsofday, MINICROP, HomemadeInDevonByJan, NotJustAMomDesigns
DunkaDunkShop: TheTAbeytaCollection, PacificLandWorks, Bexbitsandbobs, simplyposhprints, aidadelao87
MarcoPoloWood: RomanBozhkoCreative, BrickTopFurnishings, FabricationHouse, SouthernFeeling, LoveandLightPsychic
FabricationHouse: BrickTopFurnishings, RomanBozhkoCreative, BeckysCraftShack, MarcoPoloWood, SouthernFeeling
BrickTopFurnishings: RomanBozhkoCreative, FabricationHouse, OPCNaturalDynamics, MarcoPoloWood, SouthernFeeling
siyanamitkovaboneva: AngelsFaith, RubisK, BuzzysBoHoBoutique, JujuKara, Holleybeads
Welcometomyweeshop: TheFrizzyArtist, MINICROP, BillsBlingThings, simplyposhprints, mythsmapps
78Tarot: ArtDeckZero, LeatherPatches, OOOHno, CardsForToday, DinoInc
JillsOddsandEnds: CoinsAndLeather, DanielMarhuenda, BelleVieBeads, FloridasGems, RaminAndSons
FordandMcLeod: Holleybeads, Timmonsjewelry, BelleVieBeads, BuzzysBoHoBoutique, siyanamitkovaboneva
LemonFlipFlops: TruffinCrafts, DucktapeMaster77, KingsCrafts8, Verdepistacchio, LalliandMic
prettyPFdesigns: ThisNThatByJes, NotJustAMomDesigns, simplyposhprints, CardsForToday, UniquelyYourEvent
mondiBags: BigHeartStyle, SakeLatin, custombagstudio, TirelessCrafts, mybagstore
Clarich: StandoutArt, AshlingBlends, ANIZART, Majens, SariasCreates
AJAirbrushing: ArtfulLivingbyJF, LeRoiGateau, ArtisanalHeritage, ShelbyAKDesigns, custombagstudio
mythsmapps: TheFrizzyArtist, RSMRYVLTG, Welcometomyweeshop, ArtisanalHeritage, HomemadeInDevonByJan
MrsChocolateKisses: JaromiraDalebora, GemsByWjtyoung, WebsterCreative, QueensClosetofDelmar, QINC
CreatorLes: wladisla, OneCaratGems, HBHali, Welcometomyweeshop, CLKDIAMONDCO
CornwallDigitalimage: BerlangaPhotography, StarDustandStuff, CieraLShaver, HummingbirdHideout, ExodusDesign
SouthernRoyalsCoutur: thistlesnthread, FlowerSistas, JoiByJen, GingerJarTeahouse, CANDYKiDco
JennysStudio: NicNaksByPaddyWhacks, LILYandLOvintage, Javessimplesmiles, mymomentUSA, BillsBlingThings
ShelbisOddsandEnds: BillosBoutique, primsNpropers, HBHali, RaminAndSons, TasmanianAdventures
BelleVieBeads: Timmonsjewelry, FordandMcLeod, Holleybeads, BuzzysBoHoBoutique, JillsOddsandEnds
StardriftingsSeeds: FarmProducts, SifterSupply, UniquelyYourEvent, Indiciapsyche, MachiCakes
NickRissmeyer: KaykBoutique, DianeArnoldArtPrints, ExodusDesign, ChucklzDezign, RobinMasi
TitanBows: LaylaBellaBows, bowsbyalley, StyleByNikk, RaglanRoadDesigns, PreciousCreations74
KnitForDCI: TheCraftyKittens, ThisNThatByJes, ScarvesAndSelfies, LoveandLightPsychic, prettyPFdesigns
RSMRYVLTG: EnergyFocusedCrystal, mythsmapps, MarquetteLosAngeles, AshlingBlends, JillsOddsandEnds
PaperUnique: DinoInc, CreativeTexasGal, CardsForToday, OOOHno, LeatherPatches
NotJustAMomDesigns: DinoInc, prettyPFdesigns, PaperUnique, ThisNThatByJes, TirelessCrafts
StandoutArt: Instagem, SharonBsOriginals, Clarich, BelmontFineArts, ExodusDesign
angieaustindesigns: reimaginationarium, MashUpArt, SharonBsOriginals, SpanoArtclub, ECZbyElleSkye
FloridasGems: DaydreamDelusions, ThePeculiarBurrow, ChitasCreations, BelleVieBeads, Javessimplesmiles
MJCLKraft: SweetMinkyBaby, ARTFEEN, LittleFuzzyBaby, NightlySnuggles, MoniKnitsThings
ScarvesAndSelfies: CraftyGrahams, TheCraftyKittens, LalliandMic, YarnAndKnit, JoiByJen
primsNpropers: TeofiliaVintage, CheekyLouDesigns, RaminAndSons, ShelbisOddsandEnds, NotCopied
JunkDrawerBargains: HouseOfSavon, FuschiaOrchids, aidadelao87, GingerJarTeahouse, Tutusbybrandy
HomemadeInDevonByJan: NicNaksByPaddyWhacks, ZooGangStudios, PotteryAndKnitting, ArtExpoRa, VsLittleMonsters
QueensClosetofDelmar: ThePeculiarBurrow, mymomentUSA, SakeLatin, omiyuuki, BigHeartStyle
mynewshopoklok has no terms!
SossiJewelryDesign: SilkRoadVibes, BillsBlingThings, mymomentUSA, ClairMcLJewellery, AngelsFaith
Zellaknives: StarDustandStuff, NativeEncasements, LegoStorageBags, ArtGalleryAngelo, CieraLShaver
NightlySnuggles: MJCLKraft, MoreThanSprinkles, BigHeartStyle, DIN1451, FarmerSupply
NicNaksByPaddyWhacks: JennysStudio, HomemadeInDevonByJan, LILYandLOvintage, Timmonsjewelry, Javessimplesmiles
TheTownDyer: CarolinaBowties, OnesieGang, mcNEWagain, VsLittleMonsters, NightlySnuggles
SoberDecisionz: MINICROP, ScarvesAndSelfies, bkkclothing, JoiByJen, GingerJarTeahouse
SakeLatin: MyLeatherArt, mybagstore, custombagstudio, PetrenkoLeatherCraft, CroatianKnit
MachiCakes: GingerJarTeahouse, FarmProducts, StardriftingsSeeds, ARTFEEN, LemonFlipFlops
BurtonsBlooms: RobertWreaths, UniquelyYourEvent, HBHali, FlowerSistas, DellAiraDesigns
ChrisConidis: TheNerdiestMermaid, QINC, SariasCreates, CieraLShaver, Temporary5
CLKDIAMONDCO: lynnmillerlite, OneCaratGems, wladisla, ClairMcLJewellery, CreatorLes
MashUpArt: SharonBsOriginals, angieaustindesigns, JoytotheWORD, DestinedPaintings, ArtGalleryAngelo
HouseOfSavon: JunkDrawerBargains, CheekyLouDesigns, StyleByNikk, AshlingBlends, Batoidea
GundulaGause: Kleiderzauber, SchmuckSchmiede, ZauberhafteGeschenke, jessisbastelwahn, smartclever
MARIPEPAsJewelry: TheStrangeStore, TresuredTrinkets, YINGZINecklace, CharliesHandicrafts, ThePeculiarBurrow
Minkasembriodery: RaminAndSons, omiyuuki, ANDYKIMVASES, FuschiaOrchids, PreciousCreations74
FuschiaOrchids: OrangeSkyCandleShop, JunkDrawerBargains, ZooGangStudios, StealthWizards, PotteryAndKnitting
RAGGSbyLuLu: LCetLB, ConradHeart, JaromiraDalebora, FarmerSupply, FordandMcLeod
LaylaBellaBows: TitanBows, bowsbyalley, StyleByNikk, Baugher17, PreciousCreations74
DellAiraDesigns: Mi3hael, mcNEWagain, CreoFelt, BurtonsBlooms, RAGGSbyLuLu
RobinMasi: JacquelynRosesArt, CAPrisonArt, SpanoArtclub, FineScratch, LizeBeekmanART
DinoInc: PaperUnique, CreativeTexasGal, CardsForToday, OOOHno, LeatherPatches
ArtExpoRa: HomemadeInDevonByJan, ArtisanalHeritage, PotteryAndKnitting, ZooGangStudios, SarednabWorldProp
CreativeTexasGal: PaperUnique, DinoInc, CardsForToday, SariasCreates, LeatherPatches
bowsbyalley: LaylaBellaBows, TitanBows, ClassyButSassyHouse, StarDustandStuff, LoveandLightPsychic
VintageAlbertini: AliceWonderfulWorld, laultimapuntada, aidadelao87, LCetLB, Julyraindrop
DucktapeMaster77: TruffinCrafts, KingsCrafts8, LemonFlipFlops, Mi3hael, mybagstore
DaydreamDelusions: FloridasGems, ChitasCreations, ThePeculiarBurrow, wladisla, ThisNThatByJes
Brandtees: rockabilliy, Hope4Humanity, auxieltees, GemsApparel, Supercopy
JujuKara: MarquetteLosAngeles, AngelsFaith, BuzzysBoHoBoutique, LILYandLOvintage, RubisK
PitterPattaCakes: Baugher17, MoreThanSprinkles, MoniKnitsThings, sockit2U, OnesieGang
LeatherPatches: PaperUnique, DinoInc, Pleathora, CardsForToday, CreativeTexasGal
OPCNaturalDynamics: BrickTopFurnishings, Donnasdazzlingoneoff, Baugher17, ArtisanalHeritage, MJCLKraft
Pleathora: acsbk, LeatherPatches, HandMadeBackpack, PetrenkoLeatherCraft, MyLeatherArt
Bountyful: rareliterature, Bookforlife, BubbaJWoodshop, TheAlbinoPenguin, Rimukas
TheFrizzyArtist: mythsmapps, Welcometomyweeshop, ArtisanalHeritage, CieraLShaver, ChrisConidis
SariasCreates: Majens, QINC, JacquelynRosesArt, CreativeTexasGal, ChrisConidis
RobertWreaths: BurtonsBlooms, HBHali, UniquelyYourEvent, simplyposhprints, bowsbyalley
auxieltees: Supercopy, bluebeeshirt, rockabilliy, GemsApparel, DinaShirt
BillsBlingThings: SossiJewelryDesign, SilkRoadVibes, GemsByWjtyoung, JennysStudio, Welcometomyweeshop
OrangeSkyCandleShop: StealthWizards, FuschiaOrchids, AshlingBlends, StyleByNikk, ArtExpoRa
ExodusDesign: KaykBoutique, ChucklzDezign, NickRissmeyer, DianeArnoldArtPrints, MarieBrowStudio
ArtisanalHeritage: ArtExpoRa, LeRoiGateau, AJAirbrushing, TheFrizzyArtist, SarednabWorldProp
ZooGangStudios: PotteryAndKnitting, FuschiaOrchids, HomemadeInDevonByJan, ANDYKIMVASES, Donnasdazzlingoneoff
BubbaJWoodshop: Bookforlife, rareliterature, Bountyful, TheAlbinoPenguin, SarednabWorldProp
rareliterature: Bookforlife, Bountyful, BubbaJWoodshop, Rimukas, TheAlbinoPenguin
ArtDeckZero: ECZbyElleSkye, 78Tarot, SpanoArtclub, JoytotheWORD, ArtfulLivingbyJF
DesertFaire: DIN1451, DianeArnoldArtPrints, OpticalArtandDesign, ANIZART, JacquelynRosesArt
ChitasCreations: DaydreamDelusions, FloridasGems, ThePeculiarBurrow, PetrenkoLeatherCraft, QueensClosetofDelmar
bluebeeshirt: auxieltees, Supercopy, DinaShirt, rockabilliy, CrazyAwesomeTees
AubreysCottage has no terms!
Merconmbangapi: Merconmbangapi, Hawian, shouhu, murahaje, Sjoerdshop
ElleAccessori: Javessimplesmiles, BetoLCase, Holleybeads, FordandMcLeod, MINICROP
FlowerSistas: thistlesnthread, SouthernRoyalsCoutur, CraftyGrahams, CreoFelt, JaromiraDalebora
OnesieGang: MoniKnitsThings, MoreThanSprinkles, sockit2U, CANDYKiDco, Baugher17
CarolinaBowties: TheTownDyer, prettyPFdesigns, DunkaDunkShop, UniquelyYourEvent, simplyposhprints
TidelandDesigns: QyerraPawShop, Brandtees, GemsApparel, omiyuuki, DanielMarhuenda
GFPrints: Donnasdazzlingoneoff, prettyPFdesigns, Welcometomyweeshop, ZooGangStudios, DanielMarhuenda
SouthernFeeling: RomanBozhkoCreative, KitzByBlitz, MarcoPoloWood, FabricationHouse, BrickTopFurnishings
Julyraindrop: CrackerjacksTreasure, MARIPEPAsJewelry, MikabayUK, omiyuuki, VintageAlbertini
QyerraPawShop: TidelandDesigns, Brandtees, Smartship, SashaAndLolasBarkery, ElleAccessori
ARTFEEN: MJCLKraft, BerlangaPhotography, jessisbastelwahn, HBHali, MachiCakes
GemsByWjtyoung: BillsBlingThings, SilkRoadVibes, TheStrangeStore, HandMadeBackpack, MARIPEPAsJewelry
Baugher17: MoniKnitsThings, MoreThanSprinkles, OnesieGang, BrendasBabyThings, PitterPattaCakes
RaglanRoadDesigns: Rimukas, Pritchardprints, jesshandcraft, StyleByNikk, ZTBlack
aidadelao87: laultimapuntada, VintageAlbertini, AliceWonderfulWorld, TheTAbeytaCollection, LCetLB
AtlantaVintageBikes: TheAddictHome, UnknownFractals, TasmanianAdventures, CrackerjacksTreasure, SifterSupply
ClassyButSassyHouse: LegoStorageBags, LoveandLightPsychic, WebsterCreative, bowsbyalley, CornwallDigitalimage
ArtfulLivingbyJF: mybagstore, AJAirbrushing, ECZbyElleSkye, JewellGems, MyLeatherArt
Instagem: StandoutArt, MARIPEPAsJewelry, TheStrangeStore, RubisK, OOOHno
AngelsFaith: BuzzysBoHoBoutique, siyanamitkovaboneva, JujuKara, RubisK, FordandMcLeod
WoWBandz: GingerJarTeahouse, Batoidea, FlowerSistas, Timmonsjewelry, jesshandcraft
LalliandMic: Verdepistacchio, ScarvesAndSelfies, CraftyGrahams, LemonFlipFlops, JoiByJen
ECZbyElleSkye: ArtDeckZero, SpanoArtclub, JoytotheWORD, ArtfulLivingbyJF, DestinedPaintings
TheStrangeStore: MARIPEPAsJewelry, TresuredTrinkets, CharliesHandicrafts, YINGZINecklace, ThePeculiarBurrow
TheAddictHome: AtlantaVintageBikes, RubisK, CrackerjacksTreasure, CheekyLouDesigns, RaminAndSons
BelmontFineArts: SharonBsOriginals, StandoutArt, SouthernFeeling, KitzByBlitz, Weddingparaphenalia
BillosBoutique: acsbk, AngelsFaith, BuzzysBoHoBoutique, SossiJewelryDesign, ArtfulLivingbyJF
mcNEWagain: Hope4Humanity, CrazyAwesomeTees, PearlsDistrict, Brandtees, GemsApparel
lynnmillerlite: CLKDIAMONDCO, ClairMcLJewellery, mymomentUSA, GemsByWjtyoung, MikabayUK
Batoidea: WoWBandz, SarednabWorldProp, ArtExpoRa, FarmProducts, PearlsDistrict
ZaloozaPaperLove: VINTAGEBYPAULIE, CheekyLouDesigns, ARTFEEN, TheTownDyer, HBHali
MarieBrowStudio: Bexbitsandbobs, simplyposhprints, ExodusDesign, KaykBoutique, Fotobank
BunnyandSandy: TheNerdiestMermaid, DestinedPaintings, ANDYKIMVASES, JoytotheWORD, ECZbyElleSkye
DinaShirt: rockabilliy, Supercopy, DayTripApparel, auxieltees, bkkclothing
StealthWizards: OrangeSkyCandleShop, FuschiaOrchids, CardsForToday, AshlingBlends, UniquelyYourEvent
GingerJarTeahouse: WoWBandz, MachiCakes, thistlesnthread, bowsbyalley, StardriftingsSeeds
ThisNThatByJes: TheCraftyKittens, KnitForDCI, prettyPFdesigns, NotJustAMomDesigns, DaydreamDelusions
simplyposhprints: prettyPFdesigns, MarieBrowStudio, ExodusDesign, ChucklzDezign, DunkaDunkShop
CoinsAndLeather: JillsOddsandEnds, SifterSupply, AtlantaVintageBikes, Bexbitsandbobs, ArtfulLivingbyJF
LoveandLightPsychic: CardsForToday, Indiciapsyche, MarcoPoloWood, ClassyButSassyHouse, DinoInc
MoreThanSprinkles: OnesieGang, MoniKnitsThings, Baugher17, sockit2U, BrendasBabyThings
JaromiraDalebora: LCetLB, FlowerSistas, RAGGSbyLuLu, MrsChocolateKisses, ConradHeart
LaserLover has no terms!
SashaAndLolasBarkery: SashaAndLolasBarkery, StyleByNikk, QyerraPawShop, UniquelyYourEvent, FarmProducts
LizeBeekmanART: JacquelynRosesArt, LeRoiGateau, RobinMasi, FineScratch, QINC
Kesambi: Merconmbangapi, Sjoerdshop, Hawian, Mbalelo, shouhu
OOOHno: PaperUnique, DinoInc, CardsForToday, CreativeTexasGal, LeatherPatches
UniquelyYourEvent: KitzByBlitz, PitterPattaCakes, Weddingparaphenalia, prettyPFdesigns, RobertWreaths
StyleByNikk: AshlingBlends, TitanBows, SpanoArtclub, SashaAndLolasBarkery, RaglanRoadDesigns
AliceWonderfulWorld: VintageAlbertini, laultimapuntada, aidadelao87, LCetLB, AngelsFaith
SharonBsOriginals: MashUpArt, JoytotheWORD, DestinedPaintings, StandoutArt, ArtGalleryAngelo
HummingbirdHideout: BerlangaPhotography, Fotobank, ConradHeart, ZTBlack, DesertFaire
Ambramore: truevintage89, Verdepistacchio, ChitasCreations, LCetLB, DIN1451
DIN1451: DesertFaire, DianeArnoldArtPrints, ANIZART, OpticalArtandDesign, Verdepistacchio
Craftyelfenterprises: CroatianKnit, CrazyAwesomeTees, ChezMelleVintage, PetrenkoLeatherCraft, PearlsDistrict
JoiByJen: ScarvesAndSelfies, CraftyGrahams, YarnAndKnit, MINICROP, MoniKnitsThings
MikabayUK: HerPaleoCreations, RaminAndSons, Julyraindrop, FarmerSupply, Clarich
truevintage89: Ambramore, Verdepistacchio, WebsterCreative, ChrisConidis, ZauberhafteGeschenke
LILYandLOvintage: MarquetteLosAngeles, JennysStudio, NicNaksByPaddyWhacks, JujuKara, EnergyFocusedCrystal
custombagstudio: MyLeatherArt, mybagstore, SakeLatin, PetrenkoLeatherCraft, TirelessCrafts
ZauberhafteGeschenke: Kleiderzauber, GundulaGause, SchmuckSchmiede, jessisbastelwahn, VintageAlbertini
ClairMcLJewellery: mymomentUSA, OneCaratGems, SossiJewelryDesign, omiyuuki, CLKDIAMONDCO
AshlingBlends: StyleByNikk, Clarich, SpanoArtclub, RobinMasi, OrangeSkyCandleShop
FabricLetterCompany: PreciousCreations74, DanielMarhuenda, CarolinaBowties, jesshandcraft, BeckysCraftShack
CreoFelt: YarnAndKnit, RaminAndSons, FlowerSistas, DellAiraDesigns, BunnyandSandy
Bexbitsandbobs: MarieBrowStudio, DunkaDunkShop, simplyposhprints, mondiBags, ExodusDesign
PreciousCreations74: FabricLetterCompany, Minkasembriodery, HomemadeInDevonByJan, CANDYKiDco, mondiBags
HandMadeBackpack: MyLeatherArt, custombagstudio, PetrenkoLeatherCraft, SakeLatin, Pleathora
TheAlbinoPenguin: Bookforlife, rareliterature, Rimukas, Bountyful, BubbaJWoodshop
sockit2U: CANDYKiDco, OnesieGang, MoreThanSprinkles, MoniKnitsThings, Baugher17
Fotobank: HummingbirdHideout, MarieBrowStudio, ExodusDesign, TidelandDesigns, GemsApparel
jesshandcraft: Snekkerdattera, RaglanRoadDesigns, MikabayUK, FabricLetterCompany, BigHeartStyle
CharliesHandicrafts: Tutusbybrandy, TheStrangeStore, TresuredTrinkets, MARIPEPAsJewelry, YINGZINecklace
omiyuuki: mymomentUSA, ClairMcLJewellery, Minkasembriodery, QueensClosetofDelmar, SossiJewelryDesign
murahaje: IRockBlingCases, shouhu, Hawian, Merconmbangapi, Kesambi
NotCopied: Bountyful, FabricationHouse, MarcoPoloWood, primsNpropers, ChezMelleVintage
Smartship: POLEPELCUSHION, QyerraPawShop, bolabolasalju, MarcoPoloWood, ChitasCreations
mymomentUSA: ClairMcLJewellery, omiyuuki, SossiJewelryDesign, JennysStudio, QueensClosetofDelmar
MINICROP: YarnAndKnit, MoniKnitsThings, SoberDecisionz, JoiByJen, ScarvesAndSelfies
Bookforlife: BubbaJWoodshop, rareliterature, Bountyful, TheAlbinoPenguin, Rimukas
OneCaratGems: wladisla, CLKDIAMONDCO, ClairMcLJewellery, CreatorLes, SilkRoadVibes
Weddingparaphenalia: WeddingBangles, KitzByBlitz, UniquelyYourEvent, POLEPELCUSHION, BrendasBabyThings
ANIZART: DianeArnoldArtPrints, OpticalArtandDesign, DesertFaire, ChucklzDezign, DIN1451
WeddingBangles: KitzByBlitz, Weddingparaphenalia, UniquelyYourEvent, JoytotheWORD, JujuKara
WebsterCreative: truevintage89, ClassyButSassyHouse, ChrisConidis, ShelbyAKDesigns, 78Tarot
ArtGalleryAngelo: JoytotheWORD, SpanoArtclub, DestinedPaintings, SharonBsOriginals, ANIZART
shouhu: murahaje, Hawian, IRockBlingCases, Merconmbangapi, Kesambi
CAPrisonArt: FineScratch, JacquelynRosesArt, RobinMasi, LizeBeekmanART, SariasCreates
mybagstore: MyLeatherArt, custombagstudio, SakeLatin, Mi3hael, TirelessCrafts
bkkclothing: WrassleRoos, DinaShirt, rockabilliy, DayTripApparel, mondiBags
BeckysCraftShack: FabricationHouse, VsLittleMonsters, Temporary5, BunnyandSandy, FabricLetterCompany
KaykBoutique: ExodusDesign, ChucklzDezign, NickRissmeyer, DianeArnoldArtPrints, MarieBrowStudio
SarednabWorldProp: rareliterature, Rimukas, TasmanianAdventures, Batoidea, Bountyful
Snekkerdattera: handsofday, jesshandcraft, TasmanianAdventures, LegoStorageBags, OOOHno
HerPaleoCreations: FarmerSupply, MikabayUK, FarmProducts, StardriftingsSeeds, Javessimplesmiles
SpanoArtclub: ECZbyElleSkye, ArtGalleryAngelo, RobinMasi, siyanamitkovaboneva, StyleByNikk
Hawian: shouhu, murahaje, Merconmbangapi, Kesambi, IRockBlingCases
POLEPELCUSHION: bolabolasalju, Smartship, Weddingparaphenalia, NativeEncasements, GemsApparel
rockabilliy: DinaShirt, Supercopy, DayTripApparel, auxieltees, Brandtees
Pritchardprints: AnimalLetters, TheOathDesignStudio, Rimukas, RaglanRoadDesigns, DianeArnoldArtPrints
Kleiderzauber: ZauberhafteGeschenke, GundulaGause, SchmuckSchmiede, jessisbastelwahn, smartclever
guominghui2236 has no terms!
DayTripApparel: DinaShirt, rockabilliy, Supercopy, Brandtees, FarmerSupply
BetoLCase: Merconmbangapi, Hawian, Sjoerdshop, shouhu, Kesambi
ChezMelleVintage: JewellGems, PetrenkoLeatherCraft, SakeLatin, MyLeatherArt, mybagstore
Timmonsjewelry: Holleybeads, BelleVieBeads, FordandMcLeod, AngelsFaith, BuzzysBoHoBoutique
bolabolasalju: POLEPELCUSHION, NativeEncasements, IRockBlingCases, BetoLCase, shouhu
luoshuang5188 has no terms!
CrazyAwesomeTees: Hope4Humanity, PearlsDistrict, mcNEWagain, auxieltees, rockabilliy
wladisla: OneCaratGems, CreatorLes, CLKDIAMONDCO, DaydreamDelusions, ClairMcLJewellery
thistlesnthread: SouthernRoyalsCoutur, FlowerSistas, GingerJarTeahouse, TitanBows, StyleByNikk
Sjoerdshop: Kesambi, Mbalelo, Merconmbangapi, Hawian, BetoLCase
JoytotheWORD: DestinedPaintings, ArtGalleryAngelo, MashUpArt, SharonBsOriginals, ECZbyElleSkye
FarmProducts: StardriftingsSeeds, Indiciapsyche, CANDYKiDco, MachiCakes, HerPaleoCreations
TirelessCrafts: mybagstore, custombagstudio, MyLeatherArt, NotJustAMomDesigns, LegoStorageBags
Supercopy: DinaShirt, rockabilliy, auxieltees, bluebeeshirt, GemsApparel
Indiciapsyche: PotteryAndKnitting, FarmProducts, LoveandLightPsychic, StardriftingsSeeds, ClassyButSassyHouse
Mbalelo: Kesambi, Sjoerdshop, Merconmbangapi, Hawian, shouhu
ChucklzDezign: ExodusDesign, KaykBoutique, DianeArnoldArtPrints, NickRissmeyer, ANIZART
DanielMarhuenda: JillsOddsandEnds, ChrisConidis, ANIZART, TheNerdiestMermaid, GFPrints
LeRoiGateau: LizeBeekmanART, AJAirbrushing, ArtisanalHeritage, Clarich, JacquelynRosesArt
liuyuancen2260 has no terms!
BerlangaPhotography: HummingbirdHideout, CornwallDigitalimage, TheTAbeytaCollection, ARTFEEN, ZTBlack
liuyuzhi7713 has no terms!
JewelsBarkery: SashaAndLolasBarkery, StyleByNikk, QyerraPawShop, FarmProducts, DunkaDunkShop
KitzByBlitz: WeddingBangles, Weddingparaphenalia, SouthernFeeling, UniquelyYourEvent, ThisNThatByJes
YINGZINecklace: MARIPEPAsJewelry, TheStrangeStore, DestinationSouvenirs, AngelsFaith, Javessimplesmiles
DianeArnoldArtPrints: OpticalArtandDesign, ANIZART, ChucklzDezign, DIN1451, DesertFaire
IRockBlingCases: murahaje, shouhu, Hawian, Merconmbangapi, Kesambi
liuyibei1848 has no terms!
MoniKnitsThings: OnesieGang, LittleFuzzyBaby, MoreThanSprinkles, Baugher17, SweetMinkyBaby
TheOathDesignStudio: AnimalLetters, Pritchardprints, DianeArnoldArtPrints, StarDustandStuff, ExodusDesign
dongyonghe2882 has no terms!
RubisK: JujuKara, TheAddictHome, siyanamitkovaboneva, AngelsFaith, BuzzysBoHoBoutique
SifterSupply: StardriftingsSeeds, CoinsAndLeather, jessisbastelwahn, AtlantaVintageBikes, omiyuuki
