BigHeartStyle: ArtfulLivingbyJF, smartclever, Mi3hael, mondiBags, SakeLatin
TresuredTrinkets: Timmonsjewelry, MARIPEPAsJewelry, CharliesHandicrafts, LeatherPatches, wladisla
Mi3hael: TruffinCrafts, DucktapeMaster77, mybagstore, BigHeartStyle, JewellGems
CANDYKiDco: sockit2U, MoreThanSprinkles, MoniKnitsThings, OnesieGang, Baugher17
Hope4Humanity: Brandtees, OchoPlacas, mcNEWagain, OnesieGang, auxieltees
LittleFuzzyBaby: SweetMinkyBaby, VsLittleMonsters, OnesieGang, MINICROP, MoreThanSprinkles
reimaginationarium: angieaustindesigns, PaperUnique, NotJustAMomDesigns, CreativeTexasGal, HomemadeInDevonByJan
VintageRecordClocks: acsbk, GemsByWjtyoung, SifterSupply, ElleAccessori, JoytotheWORD
Holleybeads: Timmonsjewelry, NicNaksByPaddyWhacks, KnitForDCI, ElleAccessori, ThePeculiarBurrow
ANDYKIMVASES: ArtisanalHeritage, MINICROP, PotteryAndKnitting, CrackerjacksTreasure, Minkasembriodery
TruffinCrafts: DucktapeMaster77, KingsCrafts8, LemonFlipFlops, Mi3hael, mybagstore
TasmanianAdventures: DianeArnoldArtPrints, KnitForDCI, RubisK, Hawian, AtlantaVintageBikes
EnergyFocusedCrystal: RSMRYVLTG, LILYandLOvintage, MarquetteLosAngeles, LoveandLightPsychic, Fotobank
HBHali: NotJustAMomDesigns, BurtonsBlooms, ShelbisOddsandEnds, shouhu, CreatorLes
Majens: JacquelynRosesArt, DianeArnoldArtPrints, SariasCreates, LizeBeekmanART, siyanamitkovaboneva
StarDustandStuff: SariasCreates, DestinedPaintings, LizeBeekmanART, FineScratch, JacquelynRosesArt
LegoStorageBags: AJAirbrushing, bowsbyalley, ClassyButSassyHouse, SouthernRoyalsCoutur, Zellaknives
VINTAGEBYPAULIE: ZaloozaPaperLove, CheekyLouDesigns, TheTownDyer, TheFrizzyArtist, ARTFEEN
PotteryAndKnitting: ZooGangStudios, HomemadeInDevonByJan, FuschiaOrchids, ANDYKIMVASES, ArtExpoRa
JewellGems: mybagstore, ChezMelleVintage, ArtfulLivingbyJF, Craftyelfenterprises, MyLeatherArt
CroatianKnit: PetrenkoLeatherCraft, SakeLatin, ArtfulLivingbyJF, mybagstore, MoniKnitsThings
PearlsDistrict: auxieltees, CrazyAwesomeTees, Supercopy, DinaShirt, rockabilliy
RaminAndSons: CrackerjacksTreasure, CheekyLouDesigns, MikabayUK, Minkasembriodery, ChucklzDezign
Donnasdazzlingoneoff: ZooGangStudios, GFPrints, HomemadeInDevonByJan, PacificLandWorks, MikabayUK
Temporary5: angieaustindesigns, MashUpArt, ArtDeckZero, ConradHeart, TheNerdiestMermaid
KingsCrafts8: DucktapeMaster77, TruffinCrafts, LemonFlipFlops, ChezMelleVintage, DellAiraDesigns
BuzzysBoHoBoutique: BillosBoutique, BelleVieBeads, FordandMcLeod, ClairMcLJewellery, JujuKara
LCetLB: AliceWonderfulWorld, VintageAlbertini, RAGGSbyLuLu, SouthernRoyalsCoutur, LILYandLOvintage
CraftyGrahams: ScarvesAndSelfies, JoiByJen, MINICROP, YarnAndKnit, TheTownDyer
CarmelCocoDesigns has no terms!
ConradHeart: DesertFaire, HummingbirdHideout, ClairMcLJewellery, Instagem, GFPrints
Javessimplesmiles: JennysStudio, Timmonsjewelry, Welcometomyweeshop, ElleAccessori, ChucklzDezign
PacificLandWorks: TheTAbeytaCollection, DunkaDunkShop, Donnasdazzlingoneoff, TheTownDyer, BelleVieBeads
TheTAbeytaCollection: DunkaDunkShop, PacificLandWorks, ConradHeart, JunkDrawerBargains, TresuredTrinkets
handsofday: VsLittleMonsters, Smartship, LittleFuzzyBaby, LegoStorageBags, UniquelyYourEvent
WrassleRoos: auxieltees, bowsbyalley, bluebeeshirt, StardriftingsSeeds, AJAirbrushing
CrackerjacksTreasure: Julyraindrop, Minkasembriodery, ZooGangStudios, UniquelyYourEvent, RaminAndSons
RomanBozhkoCreative: MarcoPoloWood, BrickTopFurnishings, SouthernFeeling, FabricationHouse, KitzByBlitz
laultimapuntada: aidadelao87, VintageAlbertini, Ambramore, CAPrisonArt, TheNerdiestMermaid
PetrenkoLeatherCraft: MyLeatherArt, ChezMelleVintage, custombagstudio, MINICROP, HandMadeBackpack
FineScratch: KnitForDCI, Holleybeads, SouthernRoyalsCoutur, LizeBeekmanART, RobinMasi
BrendasBabyThings: SouthernRoyalsCoutur, LittleFuzzyBaby, Weddingparaphenalia, QueensClosetofDelmar, Craftyelfenterprises
UnknownFractals: AtlantaVintageBikes, TeofiliaVintage, ChrisConidis, BillosBoutique, SouthernRoyalsCoutur
MyLeatherArt: mybagstore, custombagstudio, PetrenkoLeatherCraft, SakeLatin, ChezMelleVintage
QINC: angieaustindesigns, MashUpArt, LizeBeekmanART, SariasCreates, JacquelynRosesArt
OpticalArtandDesign: DanielMarhuenda, JacquelynRosesArt, LizeBeekmanART, SariasCreates, ANIZART
OchoPlacas: Brandtees, Hope4Humanity, auxieltees, OnesieGang, JacquelynRosesArt
TheCraftyKittens: ScarvesAndSelfies, VsLittleMonsters, CharliesHandicrafts, ThisNThatByJes, KnitForDCI
DestinationSouvenirs: Hawian, murahaje, Kesambi, Merconmbangapi, Sjoerdshop
SweetMinkyBaby: LittleFuzzyBaby, PitterPattaCakes, MJCLKraft, OnesieGang, Tutusbybrandy
SchmuckSchmiede: ZauberhafteGeschenke, GundulaGause, Kleiderzauber, smartclever, SossiJewelryDesign
ShelbyAKDesigns: NotJustAMomDesigns, prettyPFdesigns, TruffinCrafts, SouthernFeeling, PaperUnique
smartclever: BigHeartStyle, Kleiderzauber, GundulaGause, SchmuckSchmiede, jessisbastelwahn
TeofiliaVintage: SouthernFeeling, TresuredTrinkets, LeatherPatches, bowsbyalley, LILYandLOvintage
SilkRoadVibes: SossiJewelryDesign, OneCaratGems, MARIPEPAsJewelry, BelleVieBeads, Mi3hael
Verdepistacchio: truevintage89, LalliandMic, Ambramore, MINICROP, TheNerdiestMermaid
MarquetteLosAngeles: JujuKara, LILYandLOvintage, Instagem, wladisla, Timmonsjewelry
jessisbastelwahn: ZauberhafteGeschenke, Kleiderzauber, smartclever, ARTFEEN, GundulaGause
JacquelynRosesArt: SariasCreates, OpticalArtandDesign, Majens, LizeBeekmanART, ECZbyElleSkye
GemsApparel: auxieltees, PearlsDistrict, rockabilliy, Fotobank, mcNEWagain
YarnAndKnit: ScarvesAndSelfies, JoiByJen, MoniKnitsThings, CraftyGrahams, CreoFelt
acsbk: LeatherPatches, VintageRecordClocks, Pleathora, ChitasCreations, SossiJewelryDesign
AnimalLetters: KaykBoutique, DianeArnoldArtPrints, Pritchardprints, LalliandMic, mondiBags
ZTBlack: Pritchardprints, MashUpArt, ConradHeart, CornwallDigitalimage, HummingbirdHideout
CheekyLouDesigns: ZaloozaPaperLove, VINTAGEBYPAULIE, RaminAndSons, HouseOfSavon, primsNpropers
Rimukas: rareliterature, Pritchardprints, Julyraindrop, SarednabWorldProp, DanielMarhuenda
DestinedPaintings: MashUpArt, JoytotheWORD, angieaustindesigns, BunnyandSandy, StarDustandStuff
TheNerdiestMermaid: angieaustindesigns, OpticalArtandDesign, ThisNThatByJes, ElleAccessori, Temporary5
FarmerSupply: auxieltees, CrazyAwesomeTees, DayTripApparel, Hope4Humanity, SouthernRoyalsCoutur
CardsForToday: prettyPFdesigns, ShelbyAKDesigns, CarolinaBowties, MarcoPoloWood, RomanBozhkoCreative
ThePeculiarBurrow: QueensClosetofDelmar, DaydreamDelusions, Javessimplesmiles, TresuredTrinkets, Holleybeads
NativeEncasements: SouthernRoyalsCoutur, KnitForDCI, AJAirbrushing, PetrenkoLeatherCraft, MyLeatherArt
Tutusbybrandy: CharliesHandicrafts, PitterPattaCakes, SouthernRoyalsCoutur, SweetMinkyBaby, LaylaBellaBows
CieraLShaver: angieaustindesigns, RobertWreaths, MarcoPoloWood, CornwallDigitalimage, CreatorLes
VsLittleMonsters: LittleFuzzyBaby, bowsbyalley, TheCraftyKittens, MINICROP, AJAirbrushing
DunkaDunkShop: TheTAbeytaCollection, CarolinaBowties, PacificLandWorks, bluebeeshirt, prettyPFdesigns
MarcoPoloWood: RomanBozhkoCreative, SouthernFeeling, FabricationHouse, WrassleRoos, CardsForToday
FabricationHouse: RomanBozhkoCreative, BrickTopFurnishings, wladisla, SouthernFeeling, MarcoPoloWood
BrickTopFurnishings: RomanBozhkoCreative, FabricationHouse, Smartship, SouthernFeeling, OPCNaturalDynamics
siyanamitkovaboneva: Timmonsjewelry, RubisK, wladisla, AngelsFaith, Welcometomyweeshop
Welcometomyweeshop: MINICROP, bluebeeshirt, Javessimplesmiles, CreatorLes, auxieltees
78Tarot: ArtDeckZero, KnitForDCI, DianeArnoldArtPrints, WebsterCreative, PaperUnique
JillsOddsandEnds: LittleFuzzyBaby, ElleAccessori, RSMRYVLTG, custombagstudio, KnitForDCI
FordandMcLeod: Timmonsjewelry, QueensClosetofDelmar, BuzzysBoHoBoutique, Holleybeads, UniquelyYourEvent
LemonFlipFlops: DucktapeMaster77, TruffinCrafts, KingsCrafts8, Tutusbybrandy, SouthernRoyalsCoutur
prettyPFdesigns: simplyposhprints, ThisNThatByJes, ShelbyAKDesigns, bluebeeshirt, auxieltees
mondiBags: TruffinCrafts, custombagstudio, TirelessCrafts, CarolinaBowties, BigHeartStyle
Clarich: SariasCreates, ANIZART, StandoutArt, OpticalArtandDesign, ArtfulLivingbyJF
AJAirbrushing: RobertWreaths, ArtfulLivingbyJF, KitzByBlitz, prettyPFdesigns, Javessimplesmiles
mythsmapps: HomemadeInDevonByJan, TheFrizzyArtist, StandoutArt, TheCraftyKittens, RSMRYVLTG
MrsChocolateKisses: lynnmillerlite, QueensClosetofDelmar, RomanBozhkoCreative, SouthernRoyalsCoutur, LittleFuzzyBaby
CreatorLes: Welcometomyweeshop, wladisla, LizeBeekmanART, ElleAccessori, OneCaratGems
CornwallDigitalimage: BerlangaPhotography, ANIZART, ArtfulLivingbyJF, KaykBoutique, ZTBlack
SouthernRoyalsCoutur: UniquelyYourEvent, JoiByJen, bowsbyalley, BrendasBabyThings, RAGGSbyLuLu
JennysStudio: Javessimplesmiles, OneCaratGems, FloridasGems, NicNaksByPaddyWhacks, BuzzysBoHoBoutique
ShelbisOddsandEnds: HBHali, AJAirbrushing, bowsbyalley, JennysStudio, LaylaBellaBows
BelleVieBeads: Timmonsjewelry, BuzzysBoHoBoutique, JujuKara, Holleybeads, ElleAccessori
StardriftingsSeeds: bowsbyalley, WrassleRoos, UniquelyYourEvent, SouthernRoyalsCoutur, Smartship
NickRissmeyer: JacquelynRosesArt, LizeBeekmanART, KaykBoutique, angieaustindesigns, MarieBrowStudio
TitanBows: LaylaBellaBows, bowsbyalley, SouthernRoyalsCoutur, PreciousCreations74, GingerJarTeahouse
KnitForDCI: Holleybeads, FineScratch, MINICROP, ScarvesAndSelfies, Baugher17
RSMRYVLTG: EnergyFocusedCrystal, AshlingBlends, ClairMcLJewellery, JillsOddsandEnds, OneCaratGems
PaperUnique: SouthernFeeling, DinoInc, ShelbyAKDesigns, UniquelyYourEvent, SouthernRoyalsCoutur
NotJustAMomDesigns: ShelbyAKDesigns, DinoInc, TirelessCrafts, HBHali, prettyPFdesigns
StandoutArt: Clarich, SharonBsOriginals, SariasCreates, MashUpArt, CreativeTexasGal
angieaustindesigns: MashUpArt, LizeBeekmanART, QINC, reimaginationarium, DestinedPaintings
FloridasGems: OneCaratGems, JennysStudio, Javessimplesmiles, Holleybeads, wladisla
MJCLKraft: NightlySnuggles, ARTFEEN, sockit2U, LittleFuzzyBaby, SweetMinkyBaby
ScarvesAndSelfies: TheCraftyKittens, CraftyGrahams, KnitForDCI, YarnAndKnit, MINICROP
primsNpropers: CheekyLouDesigns, sockit2U, MJCLKraft, FuschiaOrchids, UniquelyYourEvent
JunkDrawerBargains: FuschiaOrchids, HouseOfSavon, TheTAbeytaCollection, DunkaDunkShop, StyleByNikk
HomemadeInDevonByJan: PotteryAndKnitting, JoytotheWORD, PreciousCreations74, Donnasdazzlingoneoff, sockit2U
QueensClosetofDelmar: ThePeculiarBurrow, FordandMcLeod, custombagstudio, ChitasCreations, Holleybeads
mynewshopoklok has no terms!
SossiJewelryDesign: SilkRoadVibes, RubisK, BillsBlingThings, GemsByWjtyoung, ClairMcLJewellery
Zellaknives: KnitForDCI, DellAiraDesigns, prettyPFdesigns, LegoStorageBags, LittleFuzzyBaby
NightlySnuggles: MJCLKraft, MoreThanSprinkles, TheTownDyer, Tutusbybrandy, LittleFuzzyBaby
NicNaksByPaddyWhacks: Timmonsjewelry, Holleybeads, Javessimplesmiles, JennysStudio, LILYandLOvintage
TheTownDyer: OnesieGang, mcNEWagain, bluebeeshirt, SouthernRoyalsCoutur, CarolinaBowties
SoberDecisionz: ScarvesAndSelfies, MINICROP, JoiByJen, MoniKnitsThings, Minkasembriodery
SakeLatin: MyLeatherArt, mybagstore, PetrenkoLeatherCraft, BigHeartStyle, ArtfulLivingbyJF
MachiCakes: HerPaleoCreations, GingerJarTeahouse, mythsmapps, LemonFlipFlops, CAPrisonArt
BurtonsBlooms: RobertWreaths, CharliesHandicrafts, Minkasembriodery, Mi3hael, SouthernRoyalsCoutur
ChrisConidis: SariasCreates, OpticalArtandDesign, ArtisanalHeritage, DestinedPaintings, StandoutArt
CLKDIAMONDCO: OneCaratGems, lynnmillerlite, wladisla, ClairMcLJewellery, MARIPEPAsJewelry
MashUpArt: angieaustindesigns, SharonBsOriginals, DestinedPaintings, JoytotheWORD, SpanoArtclub
HouseOfSavon: JunkDrawerBargains, SashaAndLolasBarkery, StyleByNikk, CheekyLouDesigns, OrangeSkyCandleShop
GundulaGause: Kleiderzauber, SchmuckSchmiede, ZauberhafteGeschenke, smartclever, SakeLatin
MARIPEPAsJewelry: TresuredTrinkets, Timmonsjewelry, FuschiaOrchids, Julyraindrop, SilkRoadVibes
Minkasembriodery: CrackerjacksTreasure, PreciousCreations74, omiyuuki, ChitasCreations, SouthernRoyalsCoutur
FuschiaOrchids: JunkDrawerBargains, OrangeSkyCandleShop, MARIPEPAsJewelry, ZooGangStudios, PotteryAndKnitting
RAGGSbyLuLu: SouthernRoyalsCoutur, LILYandLOvintage, ClairMcLJewellery, QueensClosetofDelmar, LCetLB
LaylaBellaBows: TitanBows, bowsbyalley, SouthernRoyalsCoutur, DellAiraDesigns, Tutusbybrandy
DellAiraDesigns: LaylaBellaBows, KingsCrafts8, mcNEWagain, Mi3hael, Zellaknives
RobinMasi: SariasCreates, OpticalArtandDesign, LizeBeekmanART, DianeArnoldArtPrints, JacquelynRosesArt
DinoInc: NotJustAMomDesigns, PaperUnique, JacquelynRosesArt, DestinedPaintings, OOOHno
ArtExpoRa: JewelsBarkery, ZooGangStudios, LILYandLOvintage, mondiBags, CrackerjacksTreasure
CreativeTexasGal: MashUpArt, UniquelyYourEvent, KnitForDCI, SharonBsOriginals, PaperUnique
bowsbyalley: shouhu, LaylaBellaBows, SouthernRoyalsCoutur, TitanBows, VsLittleMonsters
VintageAlbertini: AliceWonderfulWorld, LCetLB, laultimapuntada, aidadelao87, LalliandMic
DucktapeMaster77: TruffinCrafts, KingsCrafts8, LemonFlipFlops, mybagstore, Mi3hael
DaydreamDelusions: ThePeculiarBurrow, TidelandDesigns, wladisla, JujuKara, Donnasdazzlingoneoff
Brandtees: OchoPlacas, OnesieGang, Hope4Humanity, Supercopy, rockabilliy
JujuKara: LILYandLOvintage, MarquetteLosAngeles, Timmonsjewelry, ClairMcLJewellery, BuzzysBoHoBoutique
PitterPattaCakes: Tutusbybrandy, sockit2U, SweetMinkyBaby, TruffinCrafts, UniquelyYourEvent
LeatherPatches: TresuredTrinkets, acsbk, ChitasCreations, TheTownDyer, ArtDeckZero
OPCNaturalDynamics: MarcoPoloWood, BrickTopFurnishings, MJCLKraft, LittleFuzzyBaby, FabricationHouse
Pleathora: acsbk, Batoidea, MashUpArt, PetrenkoLeatherCraft, MarcoPoloWood
Bountyful: NotCopied, JaromiraDalebora, SarednabWorldProp, rareliterature, CrackerjacksTreasure
TheFrizzyArtist: ECZbyElleSkye, mythsmapps, ScarvesAndSelfies, ArtDeckZero, RobinMasi
SariasCreates: Clarich, JacquelynRosesArt, OpticalArtandDesign, RobinMasi, StarDustandStuff
RobertWreaths: BurtonsBlooms, AJAirbrushing, SouthernFeeling, KnitForDCI, simplyposhprints
auxieltees: bluebeeshirt, Supercopy, DinaShirt, CrazyAwesomeTees, PearlsDistrict
BillsBlingThings: ClairMcLJewellery, GemsByWjtyoung, SossiJewelryDesign, JennysStudio, ChitasCreations
OrangeSkyCandleShop: StealthWizards, FuschiaOrchids, AshlingBlends, HouseOfSavon, Hawian
ExodusDesign: KaykBoutique, ChucklzDezign, GFPrints, Fotobank, MarieBrowStudio
ArtisanalHeritage: MINICROP, ANDYKIMVASES, KnitForDCI, CrackerjacksTreasure, ChrisConidis
ZooGangStudios: CrackerjacksTreasure, Donnasdazzlingoneoff, PotteryAndKnitting, FuschiaOrchids, HomemadeInDevonByJan
BubbaJWoodshop: Bookforlife, Bountyful, Temporary5, Pritchardprints, rareliterature
rareliterature: Bookforlife, Bountyful, BubbaJWoodshop, Rimukas, 78Tarot
ArtDeckZero: 78Tarot, LizeBeekmanART, angieaustindesigns, MashUpArt, ECZbyElleSkye
DesertFaire: HummingbirdHideout, ConradHeart, ANIZART, OpticalArtandDesign, DIN1451
ChitasCreations: Minkasembriodery, QueensClosetofDelmar, LeatherPatches, PetrenkoLeatherCraft, MyLeatherArt
bluebeeshirt: auxieltees, DinaShirt, Welcometomyweeshop, MINICROP, CrazyAwesomeTees
AubreysCottage has no terms!
Merconmbangapi: Mbalelo, Kesambi, murahaje, Hawian, shouhu
ElleAccessori: shouhu, BetoLCase, MINICROP, DinaShirt, Sjoerdshop
FlowerSistas: thistlesnthread, JoiByJen, SouthernRoyalsCoutur, QueensClosetofDelmar, JaromiraDalebora
OnesieGang: TheTownDyer, Brandtees, CANDYKiDco, LittleFuzzyBaby, sockit2U
CarolinaBowties: UniquelyYourEvent, KitzByBlitz, DunkaDunkShop, TheTownDyer, prettyPFdesigns
TidelandDesigns: DaydreamDelusions, Brandtees, GemsApparel, Majens, AnimalLetters
GFPrints: simplyposhprints, Donnasdazzlingoneoff, TheOathDesignStudio, ExodusDesign, ANIZART
SouthernFeeling: UniquelyYourEvent, KitzByBlitz, RomanBozhkoCreative, PaperUnique, DanielMarhuenda
Julyraindrop: CrackerjacksTreasure, MARIPEPAsJewelry, Minkasembriodery, CheekyLouDesigns, TheAddictHome
QyerraPawShop: Smartship, Mi3hael, SashaAndLolasBarkery, KnitForDCI, ZooGangStudios
ARTFEEN: MJCLKraft, BerlangaPhotography, jessisbastelwahn, bluebeeshirt, VINTAGEBYPAULIE
GemsByWjtyoung: BillsBlingThings, TresuredTrinkets, SossiJewelryDesign, CrazyAwesomeTees, VintageRecordClocks
Baugher17: CANDYKiDco, SouthernFeeling, KnitForDCI, GFPrints, Indiciapsyche
RaglanRoadDesigns: VsLittleMonsters, MINICROP, ClairMcLJewellery, GingerJarTeahouse, thistlesnthread
aidadelao87: laultimapuntada, VintageAlbertini, DunkaDunkShop, MarcoPoloWood, LalliandMic
AtlantaVintageBikes: TheAddictHome, CrackerjacksTreasure, Kesambi, UnknownFractals, CANDYKiDco
ClassyButSassyHouse: bowsbyalley, TruffinCrafts, WrassleRoos, BurtonsBlooms, LegoStorageBags
ArtfulLivingbyJF: mybagstore, BigHeartStyle, AJAirbrushing, JewellGems, Pritchardprints
Instagem: simplyposhprints, Timmonsjewelry, OneCaratGems, TresuredTrinkets, ClairMcLJewellery
AngelsFaith: WeddingBangles, YINGZINecklace, ClairMcLJewellery, mybagstore, siyanamitkovaboneva
WoWBandz: GingerJarTeahouse, CrazyAwesomeTees, TruffinCrafts, RaglanRoadDesigns, RobertWreaths
LalliandMic: Verdepistacchio, JoiByJen, MINICROP, ScarvesAndSelfies, Holleybeads
ECZbyElleSkye: MashUpArt, JacquelynRosesArt, angieaustindesigns, ArtDeckZero, DestinedPaintings
TheStrangeStore: Timmonsjewelry, TresuredTrinkets, MARIPEPAsJewelry, Javessimplesmiles, SossiJewelryDesign
TheAddictHome: AtlantaVintageBikes, RubisK, CrackerjacksTreasure, Julyraindrop, CheekyLouDesigns
BelmontFineArts: siyanamitkovaboneva, StandoutArt, SharonBsOriginals, SouthernFeeling, Weddingparaphenalia
BillosBoutique: BuzzysBoHoBoutique, Timmonsjewelry, ArtfulLivingbyJF, GemsApparel, acsbk
mcNEWagain: Supercopy, auxieltees, DinaShirt, Hope4Humanity, TheTownDyer
lynnmillerlite: CLKDIAMONDCO, MARIPEPAsJewelry, MrsChocolateKisses, wladisla, JennysStudio
Batoidea: Pleathora, ClassyButSassyHouse, FineScratch, ArtisanalHeritage, Zellaknives
ZaloozaPaperLove: VINTAGEBYPAULIE, CheekyLouDesigns, TheTownDyer
MarieBrowStudio: simplyposhprints, ExodusDesign, NickRissmeyer, KnitForDCI, 78Tarot
BunnyandSandy: DestinedPaintings, JoytotheWORD, angieaustindesigns, Temporary5, TheNerdiestMermaid
DinaShirt: Supercopy, auxieltees, rockabilliy, bluebeeshirt, BetoLCase
StealthWizards: OrangeSkyCandleShop, TruffinCrafts, FuschiaOrchids, RomanBozhkoCreative, custombagstudio
GingerJarTeahouse: LittleFuzzyBaby, bowsbyalley, Holleybeads, ScarvesAndSelfies, UniquelyYourEvent
ThisNThatByJes: prettyPFdesigns, UniquelyYourEvent, NotJustAMomDesigns, simplyposhprints, TheNerdiestMermaid
simplyposhprints: prettyPFdesigns, Instagem, GFPrints, MINICROP, UniquelyYourEvent
CoinsAndLeather: ArtfulLivingbyJF, JillsOddsandEnds, CrackerjacksTreasure, Pleathora, AJAirbrushing
LoveandLightPsychic: prettyPFdesigns, CarolinaBowties, MINICROP, KnitForDCI, ElleAccessori
MoreThanSprinkles: CANDYKiDco, sockit2U, LittleFuzzyBaby, NightlySnuggles, PitterPattaCakes
JaromiraDalebora: Bountyful, QueensClosetofDelmar, FlowerSistas, MarquetteLosAngeles, RaglanRoadDesigns
LaserLover has no terms!
SashaAndLolasBarkery: JewelsBarkery, StyleByNikk, HouseOfSavon, MarcoPoloWood, QyerraPawShop
LizeBeekmanART: angieaustindesigns, OpticalArtandDesign, JacquelynRosesArt, MashUpArt, ArtDeckZero
Kesambi: Mbalelo, murahaje, Hawian, Merconmbangapi, Sjoerdshop
OOOHno: NotJustAMomDesigns, DinoInc, Instagem, ShelbyAKDesigns, PaperUnique
UniquelyYourEvent: KitzByBlitz, SouthernFeeling, SouthernRoyalsCoutur, sockit2U, Weddingparaphenalia
StyleByNikk: SashaAndLolasBarkery, HouseOfSavon, JunkDrawerBargains, JewelsBarkery, OrangeSkyCandleShop
AliceWonderfulWorld: VintageAlbertini, LCetLB, Timmonsjewelry, TresuredTrinkets, JujuKara
SharonBsOriginals: MashUpArt, StandoutArt, ArtGalleryAngelo, MINICROP, angieaustindesigns
HummingbirdHideout: DesertFaire, ConradHeart, GFPrints, JacquelynRosesArt, simplyposhprints
Ambramore: truevintage89, Verdepistacchio, LalliandMic, laultimapuntada, aidadelao87
DIN1451: DesertFaire, OpticalArtandDesign, Holleybeads, ANIZART, bowsbyalley
Craftyelfenterprises: PetrenkoLeatherCraft, JewellGems, QueensClosetofDelmar, CrazyAwesomeTees, BrendasBabyThings
JoiByJen: SouthernRoyalsCoutur, FlowerSistas, YarnAndKnit, LalliandMic, LittleFuzzyBaby
MikabayUK: Donnasdazzlingoneoff, HomemadeInDevonByJan, PreciousCreations74, Minkasembriodery, RaminAndSons
truevintage89: Verdepistacchio, Ambramore, laultimapuntada, aidadelao87, ChrisConidis
LILYandLOvintage: JujuKara, MarquetteLosAngeles, Timmonsjewelry, RAGGSbyLuLu, EnergyFocusedCrystal
custombagstudio: MyLeatherArt, MINICROP, mybagstore, shouhu, PetrenkoLeatherCraft
ZauberhafteGeschenke: Kleiderzauber, jessisbastelwahn, SchmuckSchmiede, GundulaGause, smartclever
ClairMcLJewellery: OneCaratGems, JujuKara, SouthernFeeling, AngelsFaith, BuzzysBoHoBoutique
AshlingBlends: RSMRYVLTG, OrangeSkyCandleShop, EnergyFocusedCrystal, Baugher17, ChitasCreations
FabricLetterCompany: PreciousCreations74, CharliesHandicrafts, SouthernRoyalsCoutur, UniquelyYourEvent, MINICROP
CreoFelt: TheCraftyKittens, YarnAndKnit, ScarvesAndSelfies, sockit2U, DellAiraDesigns
Bexbitsandbobs: ArtfulLivingbyJF, simplyposhprints, TheCraftyKittens, mondiBags, Brandtees
PreciousCreations74: FabricLetterCompany, Minkasembriodery, JoytotheWORD, HomemadeInDevonByJan, MikabayUK
HandMadeBackpack: custombagstudio, PetrenkoLeatherCraft, MyLeatherArt, OpticalArtandDesign, ChitasCreations
TheAlbinoPenguin: ConradHeart, Brandtees, Bookforlife, Pritchardprints, BeckysCraftShack
sockit2U: CANDYKiDco, UniquelyYourEvent, PitterPattaCakes, MoniKnitsThings, OnesieGang
Fotobank: GemsApparel, ExodusDesign, EnergyFocusedCrystal, CANDYKiDco, YarnAndKnit
jesshandcraft: Snekkerdattera, BigHeartStyle, TheCraftyKittens, LegoStorageBags, VintageRecordClocks
CharliesHandicrafts: Tutusbybrandy, TresuredTrinkets, TheCraftyKittens, FabricLetterCompany, Timmonsjewelry
omiyuuki: Minkasembriodery, TresuredTrinkets, MARIPEPAsJewelry, Timmonsjewelry, ECZbyElleSkye
murahaje: shouhu, Kesambi, Mbalelo, Sjoerdshop, Hawian
NotCopied: Bountyful, wladisla, FabricationHouse, DunkaDunkShop, siyanamitkovaboneva
Smartship: BrickTopFurnishings, QyerraPawShop, StardriftingsSeeds, ANDYKIMVASES, MINICROP
mymomentUSA: KaykBoutique, SossiJewelryDesign, mcNEWagain, omiyuuki, JennysStudio
MINICROP: BetoLCase, bolabolasalju, shouhu, custombagstudio, ElleAccessori
Bookforlife: BubbaJWoodshop, rareliterature, MINICROP, TheAlbinoPenguin, Bountyful
OneCaratGems: wladisla, CLKDIAMONDCO, ClairMcLJewellery, FloridasGems, JennysStudio
Weddingparaphenalia: UniquelyYourEvent, SouthernFeeling, BrendasBabyThings, SouthernRoyalsCoutur, ANIZART
ANIZART: Clarich, OpticalArtandDesign, DesertFaire, KaykBoutique, GFPrints
WeddingBangles: AngelsFaith, CharliesHandicrafts, ClairMcLJewellery, JoytotheWORD, Timmonsjewelry
WebsterCreative: 78Tarot, ClassyButSassyHouse, WrassleRoos, GFPrints, StarDustandStuff
ArtGalleryAngelo: bluebeeshirt, ElleAccessori, custombagstudio, SharonBsOriginals, bolabolasalju
shouhu: murahaje, BetoLCase, Hawian, Kesambi, Sjoerdshop
CAPrisonArt: LizeBeekmanART, SariasCreates, DesertFaire, Mi3hael, JacquelynRosesArt
mybagstore: MyLeatherArt, JewellGems, custombagstudio, ArtfulLivingbyJF, DucktapeMaster77
bkkclothing: auxieltees, DinaShirt, rockabilliy, bluebeeshirt, CrazyAwesomeTees
BeckysCraftShack: custombagstudio, bowsbyalley, HomemadeInDevonByJan, ConradHeart, GFPrints
KaykBoutique: ExodusDesign, ANIZART, mymomentUSA, ChucklzDezign, AnimalLetters
SarednabWorldProp: KnitForDCI, Bountyful, PetrenkoLeatherCraft, TheOathDesignStudio, GFPrints
Snekkerdattera: jesshandcraft, Supercopy, handsofday, LegoStorageBags, MINICROP
HerPaleoCreations: MachiCakes, FarmProducts, MikabayUK, StyleByNikk, prettyPFdesigns
SpanoArtclub: MashUpArt, BerlangaPhotography, siyanamitkovaboneva, angieaustindesigns, ArtDeckZero
Hawian: Sjoerdshop, BetoLCase, Kesambi, shouhu, murahaje
POLEPELCUSHION: Merconmbangapi, bolabolasalju, BetoLCase, Hawian, Kesambi
rockabilliy: auxieltees, Supercopy, DinaShirt, CrazyAwesomeTees, PearlsDistrict
Pritchardprints: ArtfulLivingbyJF, ZTBlack, ConradHeart, AnimalLetters, BubbaJWoodshop
Kleiderzauber: ZauberhafteGeschenke, GundulaGause, jessisbastelwahn, SchmuckSchmiede, smartclever
guominghui2236 has no terms!
DayTripApparel: DinaShirt, bkkclothing, auxieltees, rockabilliy, GemsApparel
BetoLCase: Sjoerdshop, shouhu, Hawian, MINICROP, murahaje
ChezMelleVintage: JewellGems, PetrenkoLeatherCraft, mybagstore, MyLeatherArt, MINICROP
Timmonsjewelry: Holleybeads, TresuredTrinkets, NicNaksByPaddyWhacks, BelleVieBeads, JujuKara
bolabolasalju: BetoLCase, MINICROP, shouhu, DinaShirt, auxieltees
luoshuang5188 has no terms!
CrazyAwesomeTees: auxieltees, PearlsDistrict, DinaShirt, bluebeeshirt, rockabilliy
wladisla: OneCaratGems, TresuredTrinkets, CreatorLes, siyanamitkovaboneva, NotCopied
thistlesnthread: FlowerSistas, SouthernRoyalsCoutur, RaglanRoadDesigns, TitanBows, JoiByJen
Sjoerdshop: Hawian, BetoLCase, murahaje, Mbalelo, Kesambi
JoytotheWORD: MashUpArt, DestinedPaintings, PreciousCreations74, angieaustindesigns, HomemadeInDevonByJan
FarmProducts: StardriftingsSeeds, OrangeSkyCandleShop, HerPaleoCreations, Baugher17, DestinedPaintings
TirelessCrafts: NotJustAMomDesigns, custombagstudio, mondiBags, prettyPFdesigns, bowsbyalley
Supercopy: DinaShirt, auxieltees, rockabilliy, mcNEWagain, Brandtees
Indiciapsyche: Baugher17, FineScratch, LoveandLightPsychic, GFPrints, DanielMarhuenda
Mbalelo: Kesambi, murahaje, Merconmbangapi, Sjoerdshop, Hawian
ChucklzDezign: ExodusDesign, Javessimplesmiles, JacquelynRosesArt, ANIZART, TheOathDesignStudio
DanielMarhuenda: OpticalArtandDesign, SouthernFeeling, TruffinCrafts, JacquelynRosesArt, prettyPFdesigns
LeRoiGateau: LizeBeekmanART, angieaustindesigns, ElleAccessori, JacquelynRosesArt, Majens
liuyuancen2260 has no terms!
BerlangaPhotography: CornwallDigitalimage, MashUpArt, bluebeeshirt, ConradHeart, SpanoArtclub
liuyuzhi7713 has no terms!
JewelsBarkery: SashaAndLolasBarkery, ArtExpoRa, StyleByNikk, Holleybeads, DunkaDunkShop
KitzByBlitz: UniquelyYourEvent, SouthernFeeling, CarolinaBowties, AJAirbrushing, RomanBozhkoCreative
YINGZINecklace: AngelsFaith, Timmonsjewelry, DestinationSouvenirs, SouthernFeeling, MINICROP
DianeArnoldArtPrints: OpticalArtandDesign, Majens, TheOathDesignStudio, MashUpArt, JacquelynRosesArt
IRockBlingCases: Merconmbangapi, shouhu, murahaje, Kesambi, Sjoerdshop
liuyibei1848 has no terms!
MoniKnitsThings: CANDYKiDco, sockit2U, OnesieGang, MINICROP, LittleFuzzyBaby
TheOathDesignStudio: GFPrints, ChucklzDezign, DianeArnoldArtPrints, KnitForDCI, simplyposhprints
dongyonghe2882 has no terms!
RubisK: Timmonsjewelry, siyanamitkovaboneva, SossiJewelryDesign, wladisla, CharliesHandicrafts
SifterSupply: VintageRecordClocks, KingsCrafts8, Mi3hael, StardriftingsSeeds, omiyuuki
